
   111111111111
   1.1..1.....111
   1.1..1.1..1..1
   1.1..1.1111..1
   1.1......11..1
   11...1.1..1.11
   111111.111.1.1
     1.1..1.1.1.1
     1....1.....1
     111111111111